IRI = "countries/Iron.txt"
EAG = "countries/Eagle.txt"
NRD = "countries/Nordport.txt"
NPR = "countries/Newpor.txt"
NHA = "countries/Nothern army.txt"
MSL = "countries/Mistery land.txt"
FIS = "countries/Forgotten islands.txt"
OGV = "countries/Old government.txt"
WRW = "countries/Werewolves.txt"
PLK = "countries/Pilots korka.txt"
ACS = "countries/Aces.txt"
NLG = "countries/Northern league.txt"
RWF = "countries/Rebel werewolf fighters.txt"
UCP = "countries/Union city pz.txt"
BDT = "countries/Bedouins two.txt"
BDO = "countries/Bedouins one.txt"
BDH = "countries/Bedouins three.txt"
BDF = "countries/Bedouins four.txt"
CMU = "countries/Commune urlama.txt"
SNK = "countries/Syndicate.txt"
ARH = "countries/Arachnida.txt"
FAU = "countries/Fauna.txt"
FPA = "countries/Free ports aptoria.txt"
DWO = "countries/Darkwood.txt"
PAH = "countries/Pirates Arhip.txt"
IAT = "countries/Island ate.txt"
TRF = "countries/Thracian federation.txt"
GNR = "countries/Gnomes ridge.txt"
CGM = "countries/Conglomerate.txt"
PSS = "countries/Peninsular state.txt"
KIL = "countries/Kil.txt"
MRE = "countries/Maida raiders.txt"
BFZ = "countries/Buffer zone.txt"
MST = "countries/Mangutai station.txt"
BNR = "countries/Bourne raiders.txt"
INL = "countries/Industrial lands.txt"
PTR = "countries/Patr.txt"
SVG = "countries/Scavengers.txt"
CPP = "countries/Cappa.txt"
TBS = "countries/Tribes.txt"
ELI = "countries/Ellist.txt"
CSN = "countries/Canyon snipers.txt"
CDS = "countries/Cadian states.txt"
TCN = "countries/Trade confederation.txt"
SLB = "countries/Slope Bandits.txt"
PCO = "countries/Penal colonies.txt"
UNT = "countries/United territories.txt"
ANH = "countries/Anarchists.txt"
KLB = "countries/Kevlar brotherhood.txt"
RPB = "countries/Rotport bandits.txt"
ERM = "countries/Errum.txt"
LIP = "countries/Lips.txt"
COB = "countries/Cornsby influence.txt"
SCL = "countries/Scorched lands.txt"
KMT = "countries/Kamalyakhticha.txt"
STN = "countries/Stoned.txt"
VOS = "countries/Vassals ostoners.txt"
MHL = "countries/Motherland.txt"
SMG = "countries/Smog.txt"
ALC = "countries/Alliance.txt"
CPR = "countries/Cartel protectorate.txt"
BLH = "countries/Bloody horde.txt"
CRT = "countries/Cartel.txt"
BOC = "countries/Bone clan.txt"
GEM = "countries/Gremlin Empire.txt"
